-9
9
-5
5
0000000000000000000
1111111111111111110
1000000000000000010
1000000000000000010
1000000000000000010
1000000000000000010
1000000000000000010
1000000000111100010
1000000001111100010
1000011011111100010
1111111111111111110
